0 0 0 0 0 0 0 2 0 0 0 0 0 0 0 0
0 0 0 4 0 0 0 2 0 0 0 0 0 0 0 0
0 0 4 4 4 0 0 0 0 0 0 0 0 0 0 0
0 0 4 0 0 0 0 0 0 8 0 0 0 0 0 0
0 0 0 0 0 0 0 0 0 0 0 0 0 0 0 0
0 0 0 0 0 0 0 12 12 12 12 0 0 0 0 0 
0 0 0 0 0 0 0 12 12 12 0 0 0 0 0 0
0 0 0 0 0 0 0 0 12 12 12 0 0 0 0 0
0 0 0 0 0 0 0 0 0 12 0 0 0 0 0 0
0 0 0 0 0 0 0 0 0 0 0 0 0 0 0 0
3 3 3 0 0 0 0 0 0 0 0 0 0 0 0 0